1111111111
10000000011111
11100000000001
1000N000011111
1000000001
1111111111
