111111111111111
100000000000001
100000000000001
100000000000001
100000020000001
100000000000001
100000000000001
100000000000001
100000000000001
100000000000001
111111111111111
