11111111
10000001
10020001
10000001
11111111
